11111111111111
100C000000C001
10001100110001
10C000P0000001
10001100110001
10C000000000E1
11111111111111
